NictionalTreasure3
An Interactive Fiction by Alex Vincent & Tyler Gatta
Release 1 / Serial number 150529 / Inform 7 build 6L38 (I6/v6.33 lib 6/12N) SD

Las Vegas Home Bedroom
A king sized bed with silk sheets takes up most of the room.

There is a nightstand by the side of the bed.

>l
Las Vegas Home Bedoom
a luxurious bedroom that probably costed a lot

>n
You can't go that way.

>e
You can't go that way.

>s
You can't go that way.

* * *

NictionalTreasure3
An Interactive Fiction by Alex Vincent & Tyler Gatta
Release 1 / Serial number 150529 / Inform 7 build 6L38 (I6/v6.33 lib 6/12N) SD

Las Vegas Home Bedroom
A king sized bed with silk sheets takes up most of the room.

There is a nightstand by the side of the bed.

>spray bedroom
You can't see any such thing.

>i
You are carrying nothing.

* * *

NictionalTreasure3
An Interactive Fiction by Alex Vincent & Tyler Gatta
Release 1 / Serial number 150529 / Inform 7 build 6L38 (I6/v6.33 lib 6/12N) SD

Las Vegas Home Bedroom
A king sized bed with silk sheets takes up most of the room.

There is a nightstand by the side of the bed.

>i
You are carrying nothing.

>take spray bottle
You can't see any such thing.

* * *

NictionalTreasure3
An Interactive Fiction by Alex Vincent & Tyler Gatta
Release 1 / Serial number 150529 / Inform 7 build 6L38 (I6/v6.33 lib 6/12N) SD

Las Vegas Home Bedroom
A king sized bed with silk sheets takes up most of the room.

There is a nightstand by the side of the bed.

>home
That's not a verb I recognise.

>go home
You can't see any such thing.

>l
Smithsonian Lobby

>w
You can't go that way.

>n
Smithsonian Main Hall

>s
Smithsonian Lobby

>e
You can't go that way.

>travel
That's not a verb I recognise.

* * *

NictionalTreasure3
An Interactive Fiction by Alex Vincent & Tyler Gatta
Release 1 / Serial number 150529 / Inform 7 build 6L38 (I6/v6.33 lib 6/12N) SD

Las Vegas Home Bedroom
A king sized bed with silk sheets takes up most of the room.

There is a nightstand by the side of the bed.

>take spray bottle
Taken.

>x spray bottle
You see nothing special about the spray bottle.

* * *

NictionalTreasure3
An Interactive Fiction by Alex Vincent & Tyler Gatta
Release 1 / Serial number 150529 / Inform 7 build 6L38 (I6/v6.33 lib 6/12N) SD

Las Vegas Home Bedroom
A king sized bed with silk sheets takes up most of the room.

There is a nightstand by the side of the bed.

>x spray bottle
The bottle is full of lemon juice. Handy for finding clues.

>take spray bottle
Taken.

>l
Las Vegas Home Bedroom
A luxurious bedroom that probably cost a lot

>i
You are carrying:
  a spray bottle

>spray bedroom
You can't see any such thing.

* * *

>x spray bottle
The bottle is full of lemon juice. Handy for finding clues.

>x nightstand
You see nothing special about the nightstand.

>take nightstand
Taken.

* * *

NictionalTreasure3
An Interactive Fiction by Alex Vincent & Tyler Gatta
Release 1 / Serial number 150529 / Inform 7 build 6L38 (I6/v6.33 lib 6/12N) SD

Las Vegas Home Bedroom
A king sized bed with silk sheets takes up most of the room.

There is a nightstand by the side of the bed.

>n
You can't go that way.

* * *

NictionalTreasure3
An Interactive Fiction by Alex Vincent & Tyler Gatta
Release 1 / Serial number 150529 / Inform 7 build 6L38 (I6/v6.33 lib 6/12N) SD

Las Vegas Home Bedroom
A king sized bed with silk sheets takes up most of the room.

There is a nightstand by the side of the bed.

>open nightsand
You can't see any such thing.

>open nightstand
It isn't something you can open.

>x nightstnad
You can't see any such thing.

>x nightstand
You see nothing special about the nightstand.

>take doi
You can't see any such thing.

>take declaration of independance
You can't see any such thing.

* * *

NictionalTreasure3
An Interactive Fiction by Alex Vincent & Tyler Gatta
Release 1 / Serial number 150529 / Inform 7 build 6L38 (I6/v6.33 lib 6/12N) SD

Las Vegas Home Bedroom
A king sized bed with silk sheets takes up most of the room.

There is a nightstand by the side of the bed.

>take bed
That's fixed in place.

* * *

NictionalTreasure3
An Interactive Fiction by Alex Vincent & Tyler Gatta
Release 1 / Serial number 150529 / Inform 7 build 6L38 (I6/v6.33 lib 6/12N) SD

Las Vegas Home Bedroom
A king sized bed with silk sheets takes up most of the room.

There is a nightstand by the side of the bed.

>take pillow
Taken.

* * *

NictionalTreasure3
An Interactive Fiction by Alex Vincent & Tyler Gatta
Release 1 / Serial number 150529 / Inform 7 build 6L38 (I6/v6.33 lib 6/12N) SD

Las Vegas Home Bedroom
A king sized bed with silk sheets takes up most of the room.

There is a nightstand by the side of the bed.

>spray nighstand
You can't see any such thing.

>spray nightstand
Don't waste your juice.

* * *

NictionalTreasure3
An Interactive Fiction by Alex Vincent & Tyler Gatta
Release 1 / Serial number 150529 / Inform 7 build 6L38 (I6/v6.33 lib 6/12N) SD

Las Vegas Home Bedroom
A king sized bed with silk sheets takes up most of the room.

There is a nightstand by the side of the bed.

>spray nightstand
You need a spray bottle to do this.

>take doi
You can't see any such thing.

>open nightstand
It isn't something you can open.

* * *

>spray nightstand
You need a spray bottle to do this.

>open nightstand
You open the nightstand, revealing a spray bottle and a Declaration of Independence (declaration).

>take spray bottle
Taken.

>spray nightstand
Don't waste your juice.

>spray declaration
You spray the Declaration of Independence (declaration) with lemon juice to reveal a secret message:"There is a"

* * *

NictionalTreasure3
An Interactive Fiction by Alex Vincent & Tyler Gatta
Release 1 / Serial number 150529 / Inform 7 build 6L38 (I6/v6.33 lib 6/12N) SD

Las Vegas Home Bedroom
A king sized bed with silk sheets takes up most of the room.

There is a nightstand by the side of the bed.

>x nightstand
You see nothing special about the nightstand.

>open nightstand
You open the nightstand, revealing a The Declaration of Independence..

>take the
What do you want to take?

>declaration
You can't see any such thing.

>take the declaration of independance
You can't see any such thing.

>take the declaration of independence
You can't see any such thing.

>take The Declaration of Independence
You can't see any such thing.

>i
You are carrying nothing.

>x
What do you want to examine?

>nightstand
In the nightstand is a The Declaration of Independence..

>take the doi
Taken.

>spray the doi
You spray the The Declaration of Independence. with lemon juice to reveal a secret message

* * *

NictionalTreasure3
An Interactive Fiction by Alex Vincent & Tyler Gatta
Release 1 / Serial number 150529 / Inform 7 build 6L38 (I6/v6.33 lib 6/12N) SD

Las Vegas Home Bedroom
A king sized bed with silk sheets takes up most of the room.

There is a nightstand by the side of the bed.

>take nightstand
That's fixed in place.

>open nightstand
You open the nightstand, revealing a The Declaration of Independence.

>take declaration
Taken.

>x declaraiton
You can't see any such thing.

>x declaration
This object might contain hidden markings.

>spray declaration
You spray the The Declaration of Independence with lemon juice to reveal a secret message

* * *

NictionalTreasure3
An Interactive Fiction by Alex Vincent & Tyler Gatta
Release 1 / Serial number 150529 / Inform 7 build 6L38 (I6/v6.33 lib 6/12N) SD

Las Vegas Home Bedroom
A king sized bed with silk sheets takes up most of the room.

There is a nightstand by the side of the bed.

>spray bed
Don't waste your juice.

>spray nightstand
Don't waste your juice.

>open nightstand
You open the nightstand, revealing a The Declaration of Independence.

>ake declaration
That's not a verb I recognise.

>take declaration
Taken.

>spray declaration
You spray the The Declaration of Independence with lemon juice to reveal a secret message:You wot m8

* * *

NictionalTreasure3
An Interactive Fiction by Alex Vincent & Tyler Gatta
Release 1 / Serial number 150529 / Inform 7 build 6L38 (I6/v6.33 lib 6/12N) SD

Las Vegas Home Bedroom
A king sized bed with silk sheets takes up most of the room.

There is a nightstand by the side of the bed.

>open nightstand
You open the nightstand, revealing a spray bottle and a Declaration of Independence (declaration).

>spray declaration
You need a spray bottle to do this.

>x self
As good-looking as ever.

* * *

>spray declaration
You need a spray bottle to do this.

>take spray bottle
Taken.

>spray declaration
You spray the Declaration of Independence (declaration) with lemon juice to reveal a secret message:"There is a secret message here, but Tyler doesn't know what it is yet

* * *

>take spray bottle
Taken.

>spray declaration
You spray the Declaration of Independence (declaration) with lemon juice to reveal a secret message: 
"There is a secret message here, but Tyler doesn't know what it is yet"
The spray bottle is now (90%) full.

>spray declaration
Don't waste your juice.

* * *

NictionalTreasure3
An Interactive Fiction by Alex Vincent & Tyler Gatta
Release 1 / Serial number 150529 / Inform 7 build 6L38 (I6/v6.33 lib 6/12N) SD

Las Vegas Home Bedroom
A king sized bed with silk sheets takes up most of the room.

There is a nightstand by the side of the bed.

>x self
You are Acadamy Award winner and national-treasure-fnder, Nicolas Cage.

* * *

NictionalTreasure3
An Interactive Fiction by Alex Vincent & Tyler Gatta
Release 1 / Serial number 150529 / Inform 7 build 6L38 (I6/v6.33 lib 6/12N) SD

Las Vegas Home Bedroom
A king sized bed with silk sheets takes up most of the room.

There is a nightstand by the side of the bed.

>x nightstnad
You can't see any such thing.

>x nightstand
An ancient greek nightstand where you keep your most valuable treasures.

>x bed
You see nothing special about the bed.

* * *

NictionalTreasure3
An Interactive Fiction by Alex Vincent & Tyler Gatta
Release 1 / Serial number 150529 / Inform 7 build 6L38 (I6/v6.33 lib 6/12N) SD

Las Vegas Home Bedroom
A king sized bed with silk sheets takes up most of the room.

There is a nightstand by the side of the bed.

>x bed
The bed is still unmade from last night's escapades.

>x nightstand
An ancient greek nightstand where you keep your most valuable treasures.

>open nightstand
You open the nightstand, revealing a spray bottle and a Declaration of Independence (declaration).

>x spray bottle
The bottle is full of lemon juice. Handy for finding clues.

>x declaration
This object might contain hidden markings.

>take spray bottle
Taken.

>take declaration
Taken.

>spray declaration
You spray the Declaration of Independence (declaration) with lemon juice to reveal a secret message: "You wot m8"

>spray declaration
Don't waste your juice.

>spray nightstand
Don't waste your juice.

>take nightstand
That's fixed in place.

>close nightstand
You close the nightstand.

>x bed
The bed is still unmade from last night's escapades.

* * *

>x nightstand
An ancient greek nightstand where you keep your most valuable treasures.

>spray bed
Don't waste your juice.

* * *

NictionalTreasure3
An Interactive Fiction by Alex Vincent & Tyler Gatta
Release 1 / Serial number 150529 / Inform 7 build 6L38 (I6/v6.33 lib 6/12N) SD

Las Vegas Home Bedroom
A king sized bed with silk sheets takes up most of the room.

There is a nightstand by the side of the bed.

>x
What do you want to examine?

>x night
You can't see any such thing.

>x nightstand
An ancient Greek nightstand where you keep your most valuable treasures.

>open nightstand
You open the nightstand, revealing a spray bottle and a Declaration of Independence (declaration).

* * *

>take spray bottle
Taken.

>take Declaration
Taken.