NictionalTreasure3
An Interactive Fiction by Alex Vincent & Tyler Gatta
Release 1 / Serial number 150527 / Inform 7 build 6L38 (I6/v6.33 lib 6/12N) SD

Las Vegas Home Bedoom
a luxurious bedroom that probably costed a lot

>l
Las Vegas Home Bedoom
a luxurious bedroom that probably costed a lot